*|*|*|*|*|*|*|*|*|*
^|^|^|^|l3^|l4^|^|^|^|^
^|^|^|^|l1^|l2^|^|^|^|^
^|^|^|^|^|^|^|^|^|^
^|^|^|^|^|^|^|^|^|^
^|^|^|^|^|^|^|^|^|^
?|?|?|?|?|?|?|?|?|?
?|?|?|?|?|?|?|?|?|?
?|?|?|?|?|?|?|?|?|?
?|?|?|?|?|?|?|?|?|?
?|?|?|?|?|?|?|?|?|?
s|s|s|s|s|s|s|s|s|s