**********
^^^^^^^^^^
^^^^^^^^^^
^^^^^^^^^^
^^^^^^^^^^
^^^^^^^^^^
??????????
??????????
??????????
??????????
??????????
ssssssssss